######
#@ O.#
######

######
#@ O.#
#.O  #
######
